# # # # # # #
# _ _ _ _ _ #
# _ _ _ _ _ #
# < _ _ L _ #
F < _ _ _ _ #
# _ _ _ _ _ #
# _ _ _ B _ #
# < _ _ < _ #
# # # # # # #