# # # # # # # # #
# _ _ _ < _ B < #
# 1> B 2? ^ B < _ # # # 
F B _ < 2> _ B ^ L < #
# < B 1? < _ < < B < #
# # # # # # # # # # #
