# # # # # # #
# _ _ _ _ _ #
# _ _ _ _ _ #
# _ _ _ _ _ #
# < B 1> L < #
# 1? < B 1? < #
# B < _ < B #
# < _ _ _ < #
# # # F # # #
