# # # # # # # # # #
# _ _ _ < _ B _ < #
# 1> B 2b ?^ B < _ _ # # # #
F B _ <  2> _ _ _ ¿^ L B < #
# < B 1b <  _ < B < _ _ < #
# # # # # # # # # # # # #
