# # # # # # #
# _ _ _ _ _ #
# _ _ _ _ _ #
# _ _ _ _ _ #
# < B 1> L < # 
# B < B 1v < # 
# 1v < _ < _ # 
# < < _ _ _ #
# # # F # # #
