# # # # # # #
# _ _ _ _ _ #
# _ _ _ _ _ #
# _ _ _ _ _ #
# < _ 1> L < # 
# B < B 1? < # 
# _ < _ < _ # 
# _ _ _ _ _ #
# # # F # # #
