# # # # # # #
# _ < _ < _ #
# _ b _ B _ #
# _ > _ _ _ F
# _ B _ _ _ #
# _ _ _ _ _ #
# L < B < _ #
# _ _ _ _ _ #
# # # # # # #
