# # # # # #
# < < _ < #
# B _ _ _ #
# ^ B < _ #
# _ _ _ _ #
# _ < < L #
# F # # # #
