# # # # # # #
# _ _ _ _ _ #
# _ _ _ _ _ #
# _ _ _ _ _ #
# < _ > L < #
# B < B ? < #
# _ < _ < _ #
# _ _ _ _ _ #
# # # F # # #