# # # # # #
# < < _ < #
# _ B _ _ #
# ^ _ < _ #
# _ _ B _ #
# _ < < L #
# F # # # #
