# # # # # # #
F < _ < _ _ #
# _ _ < _ _ #
# B _ _ _ _ # # #
# < _ < _ _ _ _ #
# _ _ < _ _ _ _ #
# _ _ L _ _ # # #
# _ _ _ _ _ #
# _ _ _ _ _ #
# _ _ _ _ _ #
# _ _ _ _ _ #
# _ _ _ _ _ #
# _ _ _ _ _ #
# # # # # # #
