# F # # # #
# _ _ _ _ # # # # # 
# _ < _ _ _ B _ < #
# _ B _ _ # # # _ # 
# _ ? _ _ # . # _ #
# < < _ L # . # B #
# B # # # # . # _ #
# _ # . . . . # _ #
# _ # # # # # # B #
# < _ _ B _ _ _ < #
# # # # # # # # # #
