# # # # # # #
# _ < _ < _ #
# _ B _ _ _ #
# _ < _ B _ F
# _ _ _ _ _ #
# _ ? _ _ _ #
# L < B < _ #
# _ _ _ _ _ #
# # # # # # #