# # # # # # #
# _ _ _ _ _ #
# _ _ _ _ _ #
# _ _ _ _ _ #
# < B 1> L < # 
# B < B 1? < # 
# 1? < _ < _ # 
# < < _ _ _ #
# # # F # # #
