# # # # # # # # # #
# _ _ _ < _ B _ < #
# 1> B 2? ^ B < _ _ # # # #
F B _ <  2> _ B _ ^ L B < #
# < B 1? <  _ < B < _ _ < #
# # # # # # # # # # # # #
