# # # # # # # # # #
# ^ _ _ B _ S _ < #
# _ # # # # # # B #
# _ # . . . . # _ #
# B # # # # . # _ #
# < _ _ L # . # B #
# _ _ _ _ # . # _ #
# _ _ _ _ # # # _ # 
F < _ _ _ _ B _ < #
# _ _ _ _ # # # # # 
# # # # # #
